##############################
#............................#
#............................#
#............................#
#............................#
#............................#
#.........................$..#
#............................#
#............................#
##############################